{
    "level": 1,
	"arr": [
		[ " ", " ", "#", "r", " "], 
		[ "#", " ", "#", "#", " "],
		[ " ", "b", " ", " ", " "],
		[ "#", "#", "#", " ", "#"],
		[ "e", " ", " ", " ", "#"],
		[ " ", " ", "#", "#", " "],
		[ "#", " ", " ", " ", " "],
		[ "#", " ", "#", "#", " "],
		[ "#", ".", "y", "#", " "]
    ]
}