{
    "level": 5,
	"arr": [
		[" "," "," ","#"," "," ","#"," "," "," "," "," "],
		[" ","#"," "," "," ","#","#"," ","#","#"," ","#"],
		[" "," ","#","#"," "," "," "," ","#","#"," "," "],
		["#"," "," "," ","#","#"," ","#"," "," "," ","#"],
		["#","#","#"," ","#"," ","#","#"," ","#","#","y"],
		["#","r"," "," ","#"," "," "," "," ","#","#"," "],
		[" ","#","#"," "," "," ","#"," "," "," "," "," "],
		[" "," ","#","#","#",".","#","#","#"," ","#","#"],
		["#"," "," "," "," "," "," "," "," "," "," ","#"],
		[" "," ","#","#","#"," ","#","#"," ","#","#","b"],
		["#"," "," "," "," "," "," "," ","#"," "," "," "],
		["#"," ","#","#","#"," ","#"," "," "," ","#","#"],
		[" "," "," "," ","#","#","#"," ","#"," "," "," "]
    ]
}

