{
    "level": 4,
	"arr": [
		["r"," "," ","#","#"," "," "," ","#","#"],
		["#"," "," "," "," ","#"," "," ","#","#"],
		["#","#"," ","#","#","#","#"," "," ","#"],
		[" "," "," ","#","#"," "," "," ","#","#"],
		[" ","#"," "," ","#"," ","#","#","#","#"],
		[" "," ","#","#","#"," "," "," ","#","#"],
		["#"," ","#","#","#","#","#"," ","#"," "],
		[" "," "," "," "," "," ","#"," "," "," "],
		[" "," ","#","#","#"," "," ","#","y"," "],
		["#"," "," "," "," ","#"," "," ","#"," "],
		["#","#","#"," ","."," ","#","b"," "," "]
    ]
}

