{
    "level": 2,
	"arr": [
		[ " "," "," "," "," ","#" ],
		[ "b","#"," ","#"," "," " ],
		[ "#",".","#"," ","#"," " ],
		[ " "," ","#"," "," "," " ],
		[ " ","#"," "," ","#","#" ],
		[ " ","#"," "," "," "," " ],
		[ " "," "," ","#","#"," " ],
		[ " ","#","#"," "," "," " ],
		[ " "," ","r","#"," ","#" ],
		[ "#"," ","#","y"," ","#" ]
    ]
}

