{
    "level": 3,
	"arr": [
		["#","#"," "," ","y","#"," "," ","#"],
		["#"," "," "," ","#","#"," ","#","#"],
		[" "," ","#"," "," "," "," "," ","#"],
		[" ","#","#"," ","#","#","#"," ","#"],
		[" "," "," "," "," ","#","."," ","#"],
		[" ","#"," ","#","#","#"," ","#","#"],
		[" "," ","#"," "," "," "," ","#","#"],
		["#"," ","#","#","#","#"," ","#","r"],
		["#"," "," "," "," "," "," ","#"," "],
		[" "," ","#"," "," ","#"," ","#"," "],
		["b","#","#"," ","#","#"," "," "," "]
    ]
}

